{
    "ai": "æ",
    "ph": "f",
    "th": "t",
    "v" : "u",
    "j": "i",
    "qu": "ku"
}